Row

6: 7 + 6 + 2 == 15
5: 7 + 7 + 2 == 16
4: 6 + 8 + 1 == 15
3: 6 + 7 + 2 == 15
2: 6 + 6 + 2 == 14
1: 4 + 5 + 2 == 11
             == 86
